XXXXXXXXXXXXXXXXXXXX
X                  X
X                  X
X                  X
X                  X
X       BBB        X
X                  X
X                  X
XBBB            BBBX
X                  X
X                  X
X   BB       BB    X
X                  X 
X                  X
XXXXXXXXXXXXXXXXXXXX
XX    XX XX XX    XX
X     X      X     X
X     X      X     X
X     X      X     X
XXXXXXXXXXXXXXXXXXXX
X                  X
X                  X
X                  X
X                  X
XXXXXXXXXXXXXXXXXXXX
X                  X
X                  X
X                  X
X    XX      XX    X
XXXXXXXXXXXXXXXXXXXX
X    X        X    X
X    X        X    X
X    X        X    X
X    X        X    X
XXXXXXXXXXXXXXXXXXXX
X        X         X
X        X         X
X                  X
X           XXX    X
XXXXXXXXXXXXXXXXXXXX
XXX  X    X      XXX
X    X    X      XXX
X    X   XXX       X
X    X   XXX       X
XXXXXXXXXXXXXXXXXXXX
X                  X
X                  X
X                  X
X                  X
XXXXXXXXXXXXXXXXXXXX
X  X  X  X  X   X  X
X                  X
X                  X
X                  X
XXXXXXXXXXXXXXXXXXXX
X                  X
X                  X
X                  X
X                  X
XXXXXXXXXXXXXXXXXXXX
X                  X
X                  X
X                  X
X                  X
XXXXXXXXXXXXXXXXXXXX